1111111111111111111
1000000000000000001
1010000000000000001
10000C0C0C0C0000001
10000C0C0C0C0000001
10000C0C0C0C0100001
100C0C0C0C0C0000001
10000C0C0P0C0000011
10000C0C0C0C0000001
11111C0C0C0C0000001
1111100000C000000E1
1111111111111111111
