11111111111111111111111111
10000C01110C01000000000001
10000C01110C01000000000001
10000C01110C01000000000001
10000C01110C01000000000001
10000C01110C01000000000001
10000C01110C01000000000001
10000C01110C01000000000001
10000C01110C01000000000001
10000C01110C01000000000001
10000C0111P0C0000000000011
11111C0C0C0C00000000000011
1111100000C000000000001E01
11111111111111111111111111