1111111111111111111111111
1P0000C010010010001000001
1011101010111110101111001
1010111010100010111000001
1C100C0010110100000000001
101000000C000111111110011
1011111111111110000010001
1000001000001110101011111
1000111110000000101000C01
1011110000001111101111111
1000000011110001100000T01
1C00011100000011101111111
1000000C000001111000000E1
1111111111111111111111111
