1111111111111111111
1000000000000000001
1010000000000000001
10000C0C0C0C0000001
10000C0C0C0C0000001
10000C01110C0100001
10000C01E10C0000001
10000C0111P0C000011
10000C0C0C0C0000001
11111C0C0C0C0000001
1111100000C00000001
1111111111111111111
