1111111111111111111111111
1P0000C010000010001000001
1011101010111110101111001
1010111010100010111000001
1C100C0010110100000000001
101000000C000111111110011
1011111111111110000010001
1000001000001110101010001
1000111110000000101010C01
1011110000011111101011101
100000001111C001101000001
1C000111100T0011101111111
10000000000001111000000E1
1111111111111111111111111
