1111111111111111111111111
1011001110000001110011101
1001000010011100010000101
100100111001C101110000101
1001000010010100010000101
101110111000C001110000101
100000000000P000000000001
1000000000000000000000001
1011101110011100010000001
1000101010000100000000001
1011100000011100010000001
1010001010010000010T00001
10111011100111000100000E1
1111111111111111111111111