1111111111111111111111111111111111111111111111111111111111111
1000000000000000000000000000000000000000000000000000000000001
1010000000000000000000000000000000000000000000000000000000001
10000C0C0C0C0000000000000000000000000000000000000000000000001
10000C0C0C0C0000000000000000000000000000000000000000000000001
10000C0C0C0C0000000000000000000000000000000000000000000000001
10000C0C0C0C0000000000000000000000000000000000000000000000001
10000C0C0C0C0000000000000000000000000000000000000000000000001
10000C0C0C0C0000000000000000000000000000000000000000000000001
10000C0C0C0C0000000000000000000000000000000000000000000000001
10000C0C0C0C0000000000000000000000000000000000000000000000001
10000C0C0C0C0000000000000000000000000000000000000000000000001
10000C0C0C0C0000000000000000000000000000000000000000000000001
10000C0C0C0C0000000000000000000000000000000000000000000000001
10000C0C0C0C0000000000000000000000000000000000000000000000001
10000C0C0C0C0000000000000000000000000000000000000000000000001
10000C0C0C0C0000000000000000000000000000000000000000000000001
10000C0C0C0C0000000000000000000000000000000000000000000000001
10000C0C0C0C0000000000000000000000000000000000000000000000001
10000C0C0C0C0000000000000000000000000000000000000000000000001
10000C0C0C0C0000000000000000000000000000000000000000000000001
10000C0C0C0C0000000000000000000000000000000000000000000000001
10000C0C0C0C0000000000000000000000000000000000000000000000001
10000C0C0C0C0000000000000000000000000000000000000000000000001
10000C01110C0100000000000000000000000000000000000000000000001
10000C01010C0000000000000000000000000000000000000000000000001
10000C0111P0C000000000000000000000000000000000000000000000011
10000C0C0C0C0000000000000000000000000000000000000000000000001
11111C0C0C0C0000000000000000000000000000000000000000000000001
1111100000C000000000000000000000000000000000000000000000000E1
1111111111111111111111111111111111111111111111111111111111111
