1111111111111111111111111
1P100001C0000000000000C01
1C0001011111101101100T011
101111110001001E010000001
1000C00111110111111110101
1C0010010C01C111C0000C001
1111100110010000001001001
100C0000C0000101001001CC1
1111111111111111111111111