111111111111
10P00000C0E1
11111111111          